-9
8
-3
7
000000000000000000
000000001111111000
000000001111111000
000000001111111000
100000001111111100
100000001111111000
000000001111111000
000100001111111100
000000000000000000
000000000000000000
000000000000000110
