-18
21
-10
9
0000000000000000000000000000000000000000
0000000000000000000000000000000000000000
0000000000000000000000000000000000000000
0000000000000000011111110000000000000000
0000000000000000011111110000000000000000
0000000000000000011111110000000000000000
0000000001000000011111111000000000000000
0000000001000000011111110000000000000000
0000000000000000011111110000000000000000
0000000000001000011111111000000000000000
0000000000000000000000000000000000000000
0000000000000000000000000000000000000000
0000000000000000000000001100000000000000
0000000000000000000000000000000000000000
0000000000000000000000000000000000000000
0000000000000000000000000000000000000000
0000000000000000000000000000000000000000
0000000000000000000000000000000000000000
0000000000000000000000000000000000000000
0000000000000000000000000000000000000000
